11111111111111111111
11C00000000000011111
1PE00000000000001111
10000000000000001111
10000000000000001111
11000000000000011111
11111111111111111111
