11111111111
11C0C000011
1PE000C0001
10000000001
10000000001
11000000011
11111111111