1111111111111111111111111111111111111111
11C0000011111111111111111111111111111011
1PE0000011111111111111111111111111111001
1000000011111111111111111111111111111001
1000000011111111111111111111111111111001
1100000011111111111111111111111111111011
1111111111111111111111111111111111111111