11111111
11C00001
10C01001
10E00C01
10001001
100P0001
11111111